NO ./textures/north.xpm
SO ./textures/south.xpm
WE ./textures/west.xpm
EA ./textures/east.xpm

F 300,46,0
C -10,0,50

1111
1N01
1111

