NO ./textures/wall.xpm
SO ./textures/coin.xpm
WE ./textures/ground.xpm
EA ./textures/exit.xpm

F 220,100,0
C 225,30,0

11111111111111111111
1111111111N1111111
1111111111111111111
5