NO ./textures/wall.xpm
SO ./textures/coin.xpm
WE ./textures/ground.xpm
EA ./textures/exit.xpm

F 220,100,0
C 225,30,0

1111111
1N00001
1110111
1     1
1111111