NO ./textures/north.xpm
SO ./textures/south.xpm
WE ./textures/west.xpm
EA ./textures/east.xpm

F 138,46,0
C 0,0,50

1111111111111 111111111111
1000000000110 000000000001
1011000001110 000000000001
1001000000000 00000000000111111111
1111111110110 00001110000000000001
1000000000110 00001110111110111111
1111011111111 1011100000010001
1111011111111 1011101010010001
1100000011010 1011100000010001
1000000000000 0001100000010001
1000000000000 0001101010010001
1100000111010 1011111011110S0111
11110111 1110 101 101111010001
11111111 1111 111 111111111111
