NO ./textures/north.xpm
SO ./textures/south.xpm
WE ./textures/west.xpm
EA ./textures/east.xpm

F 100,50,20
C 10,10,10

111111
1  0 1
1  N 1
111111
