NO ./textures/wall.xpm
SO ./textures/coin.xpm
WE ./textures/ground.xpm
EA ./textures/exit.xpm

F 138,46,0
C 0,0,50

111111111111111111111111111111
100000000000000000000000000001
101111111011111111111111111101
100000001010000000000010000001
101111101010111111111010111101
100000101010100000001010100001
101110101011101111101011101101
100010100000001000001000101001
101010101111101011101011101101
100010100000001000001000100001
101110111111100011101011101101
10000000000000W000000000000001
101111111111100011111111111101
100000000000010000000000000001
101111101111010111101111101101
100000101000010100001000100001
101110101011101011101011101101
100010100000001000001000100001
101010111111101111101011101101
100000000000000000000000000001
101111111011111111111111111101
100000000010000000000010000001
101111101010111111111010111101
100000101010000000001010100001
101110101011101111101011101101
100010100000001000001000100001
101010101111101011101011101101
100000000000000000000000000001
111111111111111111111111111111
