NO ./textures/north.xpm
SO ./textures/south.xpm
WE ./textures/west.xpm
EA ./textures/east.xpm

F 200,200,200
C 100,100,100

1111111
1000001
1011101
1000001
10W0001
1000001
1111111
