NO ./textures/north.xpm
SO ./textures/south.xpm
WE ./textures/west.xpm
EA ./textures/east.xpm

SD ./textures/door.xpm
S1 ./textures/torch1.xpm
S2 ./textures/torch2.xpm
S3 ./textures/torch3.xpm
S4 ./textures/torch4.xpm

F 138,46,0
C 0,0,50

1111111111111111111111111
10000000001100000000A0001
101100A001110000000000001
100100000000000000000000111111111
11111D111111000001110000000000001
10000000001100000111011111D111111
11110111111111011100000010001
11110111111111011101010010001
11000000110101011100000010001
100000000000000011000000100A1
10000000000000001101010010001
11000001110101011111011110N0111
11110111 1110101 101111010001
11111111 1111111 111111111111
