NO ./textures/north.xpm
SO ./textures/south.xpm
WE ./textures/west.xpm
EA ./textures/east.xpm

SD ./textures/door.xpm
S1 ./textures/sprite_1.xpm
S2 ./textures/sprite_2.xpm
S3 ./textures/sprite_2.xpm
S4 ./textures/sprite_4.xpm

F 138,46,0
C 0,0,50

1111111111111111111111111
1000000000110000000000001
1011000001110000000000001
100100000000000000000000111111111
1111111D1011000001110000000000001
10000000001100000111011111D111111
1111D111111111011100000010001
1111D111111111011101010010001
11000000110101011100000010001
1000N00000000000DD000000D0001
10000000000000001101010010001
1100000111010101111101111000111
11110111 1110101 101111010001
11111111 1111111 111111111111
