NO ./textures/north.xpm
SO ./textures/south.xpm
WE ./textures/west.xpm
EA ./textures/east.xpm



F 120,120,120
C 10,10,10



11111
10001
10S01
10001
11111
