NO ./textures/wall.xpm
SO ./textures/coin.xpm
WE ./textures/ground.xpm
EA ./textures/exit.xpm

F 220,100,0
C 225,30,0


111111111111111111
100000000000000001
100000000N00000001
100000000000000001
111111111111111111